NO ./textures/wall_n.png
SO ./textures/wall_s.png


WE ./textures/wall_w.png
F 0,0,0

C 255,255,255

EA ./textures/wall_e.png


  111111 
 100N011 
  1100001
 1100001 
  1100001
   11111 