NO ./textures/wall_n.png
SO ./textures/wall_s.png
EA ./textures/wall_e.png
WE ./textures/wall_w.png
F 50,50,50
C 18,18,18

111111
100001
10N001
111111
