NO   ./textures/wall-bricks-Blue.png
SO    ./textures/wall-bricks-Blue.png


WE ./textures/wall-bricks-Blue.png
F 0,  0, 0

C  255,255, 255

EA ./textures/wall-bricks-Blue.png

  111111 
 100N011 
  1100001
 1100001 
  1100001
   11111 