NO   ./textures/wall-bricks-Blue.png
SO    ./textures/wall-bricks-Blue.png


WE ./textures/wall-bricks-Blue.png
F 30,60,90

C 70,130,180

EA ./textures/wall-bricks-Blue.png

  111111 
 10000011 
  1100001
 1100N01 
  1100001
   11111 