NO ./textures/wall_n.png
SO ./textures/wall_s.png
EA ./textures/wall_e.png
WE ./textures/wall_w.png
F 150,150,150
C 125,125,125

   111011
  101111 
 100N01  
1100001   
 1100001   
  1100001   
   11111  