NO   ./textures/wall-bricks-Blue.png
SO    ./textures/wall-bricks-Blue.png


WE ./textures/wall-bricks-Blue.png
F 30,60,90

C 70,130,180

EA ./textures/wall-bricks-Blue.png

  1111111111111111111111111111111111 
 100000000000000000000000000000011 
  1100000000000000111000000N0000111
 110000000000001111110000000000001 
  110000111100000000000000000000001
    101111100000000000000110000001
    1100000000000000000000000000111
      11111111111111111111111111